###################################
#   # ##      K                   #
# #    # ############## ######### #
# ###### #   # #      # ## ##   # #
#          # # ###### # #     # # #
###### # ### #      # # ## ##   # #
##   # # # # #### # #   ##### # # #
#  #   # #      # ## ###### #   # #
######## # ####         #   # # # #
#   #    #      ####### # # #   # #
# ### #### ######       # #   #   #
#          #      ####### #########
############ ######   # # #   #   #
#   P               #   #   #   #E#
###################################